%%%%%%%%%%%%%%%%%%%%%
% P    %%%%%        %
%                   %
% %%%%%%%% %%%%%%%% %
%        %          %
%%%%%%   % %%%%%%%% %
%        %   .      %
% %%%%%%%% %%%%%%%% %
%          %        %
%   %           %   %
%%%%%%%%%%%%%%%%%%%%%